10 10
..........
.######.#.
.#S...#.#.
.#.##.#.#.
.#.##.#.#.
.#.##.#.#.
.#.##.#.#.
.#.##.#.#.
.#......#.
.########X
